 --- --- --- --- --- --- --- --- --- 
|             v |                   |
     ---     ---         ---         
|           |   |       |   |       |
 ---         --- --- ---     ---     
|       |   |   | x                 |
         ---     --- --- ---         
|   |                   |           |
         ---         ---     ---     
|   |           |           |       |
 --- --- --- --- --- --- --- --- ---
