 --- --- --- --- --- --- --- --- --- 
| v             |                   |
     ---                 ---         
|           |           |   |       |
 ---             --- ---     ---     
|       |   |   | x                 |
         ---     --- --- ---         
|   |                   |           |
         ---         ---     ---     
|   |           |           |       |
 --- --- --- --- --- --- --- --- ---
